WWWWWWWWWWWWWWWWWWWW
WTCT.W..W.WW..CWTC.W
WW.....T.WCC.TW..WCW
WC.C.T.TTCTW.CTT.WWW
W.W..CCC.C.T.T..TCTW
WT...WC..CW....WCC.W
WCT.C...WC...CTCCCWW
W.C.TW.TWTWTCTCW.TWW
WWW...WT..W..TT..WCW
WTT.TWC.T...WTWWWCCW
W...C.TCW.TC..C.TW.W
WCTC..CWC.CT...CWC.W
WTWWC.W.C.T.CWC..W.W
WWC....C.W.....CTWTW
WC.TCWTW.T.C..T.TC.W
WWWWWWWWWWWWWWWWWWWW
