WWWWWWWWWWWWWWWWWWWW
WTCT....WWW...W..C.W
W...CWWTTWCT.TWC..CW
WC....T.TCCW.CTW.W.W
W.....CCWT.CTTT.TC.W
WT....TW..CWC..WCC.W
WCTCT.W.WC....T.WWCW
W.CC.T.TWTTTCTCW.TWW
WTWCW.W...T..TTC..CW
WTW..WC.T...W.CTT.WW
W...TCTC..TCC.C.TW.W
WCTCCCCWCC.TTWWTWCTW
WTW.C.W...W...TWWWTW
W.C.CTC..TW.CW.CT..W
WC.TC.TW.C.CTWWTTCWW
WWWWWWWWWWWWWWWWWWWW
