WWWWWWWWWWWWWWWWWWWW
WTCT.C..T.W..WWT.CCW
WC.....T.WCT.TW...CW
WC.C.T..TCCW.CTT.WWW
W....CCC.C.T.T..TCWW
W....TC..CW.CCTWCCCW
WCT..C...T..TCTCTW.W
W.C..W..WWW..TCW.TWW
WWW.C.WT.WT..TT..WCW
WTWT..C.T...T.TWCT.W
W...CTTC..TCCCCWTC.W
WTT.TTCWW..TTW.C.CTW
WTT.C.W.T.TCCW...WWW
WWC...W..C..W..T.TTW
WC..CWWT.CCCCCW.TC.W
WWWWWWWWWWWWWWWWWWWW
