WWWWWWWWWWWWWWWWWWWW
W.CT...W.WW.T.WW.T.W
W......TTCC...W...CW
WC.CTTT.TWC.CCT..WWW
W.C...CC.C.TTT...C.W
WT.C.W....W.C.CWCC.W
WCT...WS.CT.TCWCC.WW
W.C.TT.TWTW.TTCC.T.W
WWW.TT....T..TT..WCW
WTW..WC.T...W.WWCT.W
WC..CCTC...CC.T..W.W
WCT.WCCWTW.TTC.W.CTW
WT.TWTWCW.TTCWWW.WWW
W.....C..T..CT.TTTTW
WTTTCTC..W.T.CW...TW
WWWWWWWWWWWWWWWWWWWW
