WWWWWWWWWWWWWWWWWWWW
WTCT....W.WT..CWTC.W
WW.....T.WCC.TWC..CW
WC.C.T..TCTW.CTT.WWW
W.W..CTC.C.T.T..TWTW
WT...W...CW....WCC.W
WCT.C...WC...CT.CCWW
W.C..W.TWT.TCTCW.TWW
WWWW..WT..W..TT..WCW
WTT.TCC.T...W.WWWCTW
W...CCTCW.TC..C.TW.W
WCTC..CWC..T..TCWT.W
WTWWC.W.C.T.CWC..WWW
WWC..CCCTC.....CT.TW
WC.TTWTW.C.C..T.TC.W
WWWWWWWWWWWWWWWWWWWW
